R 900 600



NO images/textures/blue_cell.xpm
SO images/textures/blue_cell.xpm
WE images/textures/blue_cell.xpm
EA images/textures/white_bricks.xpm
S  images/sprites/table.xpm

F 148, 255, 0
C 105, 105, 255

        111111111111111111111111
        1000000000110000000000001
        10110000011100000E0000001
        1001000000000000000000001
111111111011000001110000000000001
100000000011000001110111110111111
11110111111111011100000010001
11110111111111011101010010001
11000000110101011100000010001
10000000000000001100000010001
10000000000000001101010010001
1100000111010101111101111000111
11110111 1110101 101111010001
11111111 1111111 111111111111
