R 2560 1440
NO images/textures/gray_wall_1.xpm
SO images/textures/gray_wall_glued.xpm
WE images/textures/steel_wall.xpm
EA images/textures/white_bricks.xpm
S  images/sprites/light.xpm

F 148, 200, 108
C 105, 105, 255

        1111111111111111111111111
        1000000000110000000000001
        1011000001110022220000001
        1001E00000000000000000001
111111111011000001110000000000001
100000000011000021110111110111111
11110111111111011100000010001
11110111111111011101010010001
11000000110101011100000010001
10002000000000001100000010001
10000002222000001101010010001
1100000111010101111101111000111
11110111 1110101 101111010001
11111111 1111111 111111111111
