R 1024 1024
NO images/textures/brick_wall.xpm
SO images/textures/brick_wall.xpm
WE images/textures/blue_cell.xpm
EA images/textures/blue_wall.xpm
S  images/sprites/barrel.xpm

F 148, 200, 108
C 105, 105, 255

1111111111111111111111111111111111111111111111111111111111111111
1000000000000000000000000000000000000000000000000000000000000001
1000000000000000000000000000000000000000000000000000000000000001
1000200000000000000000000000000000000000000000000000000000000001
1000000000000000000000000000000000000000000000000000000000000001
1000000000000000000000000000000000000000000000000000000000000001
1000000020000000000000000000000000000000000000000000000000000001
1000000000000000000000000000000000000000000000000000000000000001
1000000000000000000000000000000000000000000000000000000000002001
1000000000002000000000000000000000000000000000000000000000000001
1000000000000000000000000000000000000000000000000000000000000001
1000000000000000000000000000000000000000000000000000000020000001
1000000000000000200000000000000000000000000000000000000000000001
1000000000000000000000000000000000000000000000000000000000000001
1000000000000000000000000000000000000000000000000000200000000001
1000000000000000000020000000000000000000000000000000000000000001
1000000000000000000000000000000000000000000000000000000000000001
1000000000000000000000000000000000000000000000002000000000000001
1000000000000000000000002000000000000000000000000000000000000001
1000000000000000000000000000000000000000000000000000000000000001
100000000000E000000000000000000000000000000020000000000000000001
1000000000000000000000000000200000000000000000000000000000000001
1000000000000000000000000000000000000000000000000000000000000001
1000000000000000000000000000000000000000200000000000000000000001
1000000000000000000000000000000020000000000000000000000000000001
1000000000000000000000000000000000000000000000000000000000000001
1000000000000000000000000000000000002000000000000000000000000001
1000000000000000000000000000000000002000000000000000000000000001
1000000000000000000000000000000000000000000000000000000000000001
1000000000000000000000000000000020000000000000000000000000000001
1000000000000000000000000000000000000000200000000000000000000001
1000000000000000000000000000000000000000000000000000000000000001
1000000000000000000000000000200000000000000000000000000000000001
1000000000000000000000000000000000000000000020000000000000000001
1000000000000000000000000000000000000000000000000000000000000001
1000000000000000000000002000000000000000000000000000000000000001
1000000000000000000000000000000000000000000000002000000000000001
1000000000000000000000000000000000000000000000000000000000000001
1000000000000000000020000000000000000000000000000000000000000001
1000000000000000000000000000000000000000000000000000200000000001
1000000000000000000000000000000000000000000000000000000000000001
1000000000000000200000000000000000000000000000000000000000000001
1000000000000000000000000000000000000000000000000000000020000001
1000000000000000000000000000000000000000000000000000000000000001
1000000000002000000000000000000000000000000000000000000000000001
1000000000000000000000000000000000000000000000000000000000002001
1000000000000000000000000000000000000000000000000000000000000001
1000000020000000000000000000000000000000000000000000000000000001
1000000000000000000000000000000000000000000000000000000000000001
1000000000000000000000000000000000000000000000000000000000000001
1000200000000000000000000000000000000000000000000000000000000001
1000000000000000000000000000000000000000000000000000000000000001
1000000000000000000000000000000000000000000000000000000000000001
1000000000000000000000000000000000000000000000000000000000000001
1111111111111111111111111111111111111111111111111111111111111111
