R 1440 900
NO images/textures/brick_wall.xpm
SO images/textures/brick_wall.xpm
WE images/textures/blue_cell.xpm
EA images/textures/blue_wall.xpm
S  images/sprites/table.xpm

F 255, 255, 100
C 105, 205, 205

1111111111111111111111111111111111111111111111111111111111111111111111111111111111111111111111111111111111111111111111111111111111111111111111111111111111111111111111111111111111111111111111111111111111111111111111111111111111111111111111111
1000000000000000000000000000000000000000000000000000000000000000000000000000000000000000000000000000000000000000000000000000000000000000000000000000000000000000000000000000000000000000000000000000000000000000000000000000000000000000000000001
1000111100011110000011110000001111000000111100000111100011110001111000111100000111100000011110000001111000001111000111100011110001111000001111000000111100000011110000011110001111000111100011110000011110000001111000000111100000111100011110001
1000000000000000000000000000000000000000000000000000000000000000000000000000000000000000000000000000000000000000000000000000000000000000000000000000000000000000000000000000000000000000000000000000000000000000000000000000000000000000000000001
1000111100011110000011110000001111000000111100000111100011110001111000111100000111100000011110000001111000001111000111100011110001111000001111000000111100000011110000011110001111000111100011110000011110000001111000000111100000111100011110001
1000000000000000000000000000000000000000000000000000000000000000000000000000000000000000000000000000000000000000000000000000000000000000000000000000000000000000000000000000000000000000000000000000000000000000000000000000000000000000000000001
1000111100011110000011110000001111000000111100000111100011110001111000111100000111100000011110000001111000001111000111100011110001111000001111000000111100000011110000011110001111000111100011110000011110000001111000000111100000111100011110001
1000000000000000000000000000000000000000000000000000000000000000000000000000000000000000000000000000000000000000000000000000000000000000000000000000000000000000000000000000000000000000000000000000000000000000000000000000000000000000000000001
1000111100011110000011110000001111000000111100000111100011110001111000111100000111100000011110000001111000001111000111100011110001111000001111000000111100000011110000011110001111000111100011110000011110000001111000000111100000111100011110001
1000000000000000000000000000000000000000000000000000000000000000000000000000000000000000000000000000000000000000000000000000000000000000000000000000000000000000000000000000000000000000000000000000000000000000000000000000000000000000000000001
1000111100011110000011110000001111000000111100000111100011110001111000111100000111100000011110000001111000001111000111100011110001111000001111000000111100000011110000011110001111000111100011110000011110000001111000000111100000111100011110001
1000000000000000000000000000000000000000000000000000000000000000000000000000000000000000000000000000000000000000000000000000000000000000000000000000000000000000000000000000000000000000000000000000000000000000000000000000000000000000000000001
1000111100011110000011110000001111000000111100000111100011110001111000111100000111100000011110000001111000001111000111100011110001111000001111000000111100000011110000011110001111000111100011110000011110000001111000000111100000111100011110001
1000000000000000000000000000000000000000000000000000000000000000000000000000000000000000000000000000000000000000000000000000000000000000000000000000000000000000000000000000000000000000000000000000000000000000000000000000000000000000000000001
1000111100011110000011110000001111000000111100000111100011110001111000111100000111100000011110000001111000001111000111100011110001111000001111000000111100000011110000011110001111000111100011110000011110000001111000000111100000111100011110001
1000000000000000000000000000000000000000000000000000000000000000000000000000000000000000000000000000000000000000000000000000000000000000000000000000000000000000000000000000000000000000000000000000000000000000000000000000000000000000000000001
1000111100011110000011110000001111000000111100000111100011110001111000111100000111100000011110000001111000001111000111100011110001111000001111000000111100000011110000011110001111000111100011110000011110000001111000000111100000111100011110001
1000000000000000000000000000000000000000000000000000000000000000000000000000000000000000000000000000000000000000000000000000000000000000000000000000000000000000000000000000000000000000000000000000000000000000000000000000000000000000000000001
1000111100011110000011110000001111000000111100000111100011110001111000111100000111100000011110000001111000001111000111100011110001111000001111000000111100000011110000011110001111000111100011110000011110000001111000000111100000111100011110001
1000000000000000000000000000000000000000000000000000000000000000000000000000000000000000000000000000002020202020200000000000000000000000000000000000000000000000000000000000000000000000000000000000000000000000000000000000000000000000000000001
100011110001111000001111000000111100000011110000011110001111000111100011110000011110000001111000000E000202020202000111100011110001111000001111000000111100000011110000011110001111000111100011110000011110000001111000000111100000111100011110001
1000000000000000000000000000000000000000000000000000000000000000000000000000000000000000000000000000002020202020200000000000000000000000000000000000000000000000000000000000000000000000000000000000000000000000000000000000000000000000000000001
1000111100011110000011110000001111000000111100000111100011110001111000111100000111100000011110000001111000001111000111100011110001111000001111000000111100000011110000011110001111000111100011110000011110000001111000000111100000111100011110001
1000000000000000000000000000000000000000000000000000000000000000000000000000000000000000000000000000000000000000000000000000000000000000000000000000000000000000000000000000000000000000000000000000000000000000000000000000000000000000000000001
1000111100011110000011110000001111000000111100000111100011110001111000111100000111100000011110000001111000001111000111100011110001111000001111000000111100000011110000011110001111000111100011110000011110000001111000000111100000111100011110001
1000000000000000000000000000000000000000000000000000000000000000000000000000000000000000000000000000000000000000000000000000000000000000000000000000000000000000000000000000000000000000000000000000000000000000000000000000000000000000000000001
1000111100011110000011110000001111000000111100000111100011110001111000111100000111100000011110000001111000001111000111100011110001111000001111000000111100000011110000011110001111000111100011110000011110000001111000000111100000111100011110001
1000000000000000000000000000000000000000000000000000000000000000000000000000000000000000000000000000000000000000000000000000000000000000000000000000000000000000000000000000000000000000000000000000000000000000000000000000000000000000000000001
1000111100011110000011110000001111000000111100000111100011110001111000111100000111100000011110000001111000001111000111100011110001111000001111000000111100000011110000011110001111000111100011110000011110000001111000000111100000111100011110001
1000000000000000000000000000000000000000000000000000000000000000000000000000000000000000000000000000000000000000000000000000000000000000000000000000000000000000000000000000000000000000000000000000000000000000000000000000000000000000000000001
1000111100011110000011110000001111000000111100000111100011110001111000111100000111100000011110000001111000001111000111100011110001111000001111000000111100000011110000011110001111000111100011110000011110000001111000000111100000111100011110001
1000000000000000000000000000000000000000000000000000000000000000000000000000000000000000000000000000000000000000000000000000000000000000000000000000000000000000000000000000000000000000000000000000000000000000000000000000000000000000000000001
1000111100011110000011110000001111000000111100000111100011110001111000111100000111100000011110000001111000001111000111100011110001111000001111000000111100000011110000011110001111000111100011110000011110000001111000000111100000111100011110001
1000000000000000000000000000000000000000000000000000000000000000000000000000000000000000000000000000000000000000000000000000000000000000000000000000000000000000000000000000000000000000000000000000000000000000000000000000000000000000000000001
1000111100011110000011110000001111000000111100000111100011110001111000111100000111100000011110000001111000001111000111100011110001111000001111000000111100000011110000011110001111000111100011110000011110000001111000000111100000111100011110001
1000000000000000000000000000000000000000000000000000000000000000000000000000000000000000000000000000000000000000000000000000000000000000000000000000000000000000000000000000000000000000000000000000000000000000000000000000000000000000000000001
1000111100011110000011110000001111000000111100000111100011110001111000111100000111100000011110000001111000001111000111100011110001111000001111000000111100000011110000011110001111000111100011110000011110000001111000000111100000111100011110001
1000000000000000000000000000000000000000000000000000000000000000000000000000000000000000000000000000000000000000000000000000000000000000000000000000000000000000000000000000000000000000000000000000000000000000000000000000000000000000000000001
1000111100011110000011110000001111000000111100000111100011110001111000111100000111100000011110000001111000001111000111100011110001111000001111000000111100000011110000011110001111000111100011110000011110000001111000000111100000111100011110001
1000000000000000000000000000000000000000000000000000000000000000000000000000000000000000000000000000000000000000000000000000000000000000000000000000000000000000000000000000000000000000000000000000000000000000000000000000000000000000000000001
1000111100011110000011110000001111000000111100000111100011110001111000111100000111100000011110000001111000001111000111100011110001111000001111000000111100000011110000011110001111000111100011110000011110000001111000000111100000111100011110001
1000000000000000000000000000000000000000000000000000000000000000000000000000000000000000000000000000000000000000000000000000000000000000000000000000000000000000000000000000000000000000000000000000000000000000000000000000000000000000000000001
1000111100011110000011110000001111000000111100000111100011110001111000111100000111100000011110000001111000001111000111100011110001111000001111000000111100000011110000011110001111000111100011110000011110000001111000000111100000111100011110001
1000000000000000000000000000000000000000000000000000000000000000000000000000000000000000000000000000000000000000000000000000000000000000000000000000000000000000000000000000000000000000000000000000000000000000000000000000000000000000000000001
1000111100011110000011110000001111000000111100000111100011110001111000111100000111100000011110000001111000001111000111100011110001111000001111000000111100000011110000011110001111000111100011110000011110000001111000000111100000111100011110001
1000000000000000000000000000000000000000000000000000000000000000000000000000000000000000000000000000000000000000000000000000000000000000000000000000000000000000000000000000000000000000000000000000000000000000000000000000000000000000000000001
1000111100011110000011110000001111000000111100000111100011110001111000111100000111100000011110000001111000001111000111100011110001111000001111000000111100000011110000011110001111000111100011110000011110000001111000000111100000111100011110001
1000000000000000000000000000000000000000000000000000000000000000000000000000000000000000000000000000000000000000000000000000000000000000000000000000000000000000000000000000000000000000000000000000000000000000000000000000000000000000000000001
1000111100011110000011110000001111000000111100000111100011110001111000111100000111100000011110000001111000001111000111100011110001111000001111000000111100000011110000011110001111000111100011110000011110000001111000000111100000111100011110001
1000000000000000000000000000000000000000000000000000000000000000000000000000000000000000000000000000000000000000000000000000000000000000000000000000000000000000000000000000000000000000000000000000000000000000000000000000000000000000000000001
1000111100011110000011110000001111000000111100000111100011110001111000111100000111100000011110000001111000001111000111100011110001111000001111000000111100000011110000011110001111000111100011110000011110000001111000000111100000111100011110001
1000000000000000000000000000000000000000000000000000000000000000000000000000000000000000000000000000000000000000000000000000000000000000000000000000000000000000000000000000000000000000000000000000000000000000000000000000000000000000000000001
1000111100011110000011110000001111000000111100000111100011110001111000111100000111100000011110000001111000001111000111100011110001111000001111000000111100000011110000011110001111000111100011110000011110000001111000000111100000111100011110001
1000000000000000000000000000000000000000000000000000000000000000000000000000000000000000000000000000000000000000000000000000000000000000000000000000000000000000000000000000000000000000000000000000000000000000000000000000000000000000000000001
1000111100011110000011110000001111000000111100000111100011110001111000111100000111100000011110000001111000001111000111100011110001111000001111000000111100000011110000011110001111000111100011110000011110000001111000000111100000111100011110001
1000000000000000000000000000000000000000000000000000000000000000000000000000000000000000000000000000000000000000000000000000000000000000000000000000000000000000000000000000000000000000000000000000000000000000000000000000000000000000000000001
1111111111111111111111111111111111111111111111111111111111111111111111111111111111111111111111111111111111111111111111111111111111111111111111111111111111111111111111111111111111111111111111111111111111111111111111111111111111111111111111111
