R 1280 720
NO images/textures/gray_wall_1.xpm
SO images/textures/gray_wall_1.xpm
WE images/textures/gray_wall_1.xpm
EA images/textures/gray_wall_1.xpm
S  images/sprites/barrel.xpm

F 148, 200, 108
C 105, 105, 255

111111111111111111111111111111111
1222222222222222222222222222100001
1222222222222222222222222222100001
1222222222222222222222222222100001
1222222222222222222222222222100001
12E2222222222222222222222222100001
1222222222222222222222222222100001
1222222222222222222222222222100001
1222222222222222222222222222100001
1222222222222222222222222222100001
111111111111111111111111111111111
